{
  "maze1": [
    ["W", "W", "W", "W", "W", "W", "W", "W", "W", "W", "W", "W", "W", "W", "W", "S", "W", "W", "W", "W", "W", "W", "W", "W", "W", "W", "W", "W", "W", "W", "W", "W", "W", "W", "W", "W", "W", "W", "W", "W", "W"],
    ["W", " ", "W", " ", "W", " ", " ", " ", "W", " ", " ", " ", " ", " ", "W", " ", "W", " ", "W", " ", " ", " ", " ", " ", "W", " ", " ", " ", "W", " ", " ", " ", "W", " ", "W", " ", "W", " ", "W", " ", "W"],
    ["W", " ", " ", " ", "W", " ", "W", " ", "W", " ", "W", "W", "W", " ", "W", " ", "W", " ", "W", " ", "W", " ", "W", " ", "W", " ", "W", "W", "W", " ", "W", " ", "W", " ", "W", " ", "W", " ", "W", " ", "W"],
    ["W", " ", "W", " ", "W", " ", "W", " ", "W", " ", " ", " ", "W", " ", "W", " ", " ", " ", " ", " ", "W", " ", "W", " ", "W", " ", " ", " ", " ", " ", "W", " ", "W", " ", "W", " ", "W", " ", " ", " ", "W"],
    ["W", " ", "W", " ", "W", " ", "W", " ", "W", " ", " ", " ", " ", " ", "W", " ", "W", "W", "W", "W", "W", " ", "W", "W", "W", " ", "W", " ", " ", " ", " ", " ", " ", " ", "W", " ", "W", " ", "W", " ", "W"],
    ["W", " ", "W", " ", "W", " ", "W", "W", "W", " ", " ", " ", "W", " ", "W", " ", "W", " ", "W", " ", " ", " ", "W", " ", "W", " ", " ", " ", " ", " ", " ", " ", "W", " ", " ", " ", " ", " ", " ", " ", "W"],
    ["W", "W", "W", " ", "W", " ", "W", " ", "W", "W", "W", "W", "W", " ", "W", " ", "W", " ", "W", " ", "W", " ", "W", " ", "W", " ", "W", " ", "W", "W", "W", "W", "W", " ", "W", "W", "W", " ", "W", " ", "W"],
    ["W", " ", " ", " ", " ", " ", "W", " ", "W", " ", " ", " ", "W", " ", "W", " ", "W", " ", "W", " ", " ", " ", "W", " ", "W", " ", " ", " ", "W", " ", " ", " ", " ", " ", "W", " ", "W", " ", "W", " ", "W"],
    ["W", " ", " ", " ", "W", " ", " ", " ", " ", " ", " ", " ", "W", " ", "W", " ", " ", " ", "W", " ", " ", " ", "W", " ", " ", " ", " ", " ", " ", " ", " ", " ", " ", " ", "W", " ", "W", " ", " ", " ", "W"],
    ["W", " ", "W", "W", "W", " ", "W", " ", "W", " ", "W", "W", "W", " ", "W", " ", "W", "W", "W", "W", "W", " ", "W", " ", "W", " ", "W", " ", "W", "W", "W", "W", "W", "W", "W", " ", "W", " ", "W", " ", "W"],
    ["W", " ", "W", " ", "W", " ", "W", " ", "W", " ", "W", " ", " ", " ", " ", " ", "W", " ", "W", " ", " ", " ", "W", " ", "W", " ", "W", " ", " ", "W", " ", " ", " ", " ", "W", " ", "W", " ", "W", " ", "W"],
    ["W", " ", "W", " ", "W", " ", "W", "W", "W", " ", "W", " ", " ", " ", "W", " ", "W", " ", "W", " ", "W", " ", "W", " ", "W", " ", "W", " ", " ", "W", " ", " ", " ", " ", " ", " ", "W", " ", "W", " ", "W"],
    ["W", "W", "W", " ", "W", "W", "W", " ", "W", " ", "W", " ", " ", " ", "W", " ", "W", " ", " ", " ", "W", " ", " ", " ", " ", " ", " ", " ", " ", " ", "W", "W", " ", "W", " ", " ", "W", " ", "W", " ", "W"],
    ["W", " ", " ", " ", "W", " ", "W", " ", "W", " ", "W", "W", "W", " ", "W", "W", "W", " ", "W", " ", "W", " ", " ", "W", "W", "W", "W", "W", "W", "W", " ", " ", "W", " ", " ", " ", "W", " ", "W", " ", "W"],
    ["W", " ", "W", " ", " ", " ", " ", " ", "W", " ", "W", " ", " ", " ", " ", " ", " ", " ", " ", "W", " ", " ", " ", " ", " ", " ", " ", "W", " ", " ", " ", " ", " ", " ", "W", " ", " ", " ", "W", " ", "W"],
    ["W", " ", "W", "W", "W", " ", "W", " ", "W", " ", "W", "W", "W", " ", "W", "W", "W", "W", "W", "W", "W", "W", "W", "W", "W", "W", "W", "W", "W", "W", "W", " ", "W", " ", "W", " ", "W", " ", "W", " ", "W"],
    ["W", " ", " ", " ", " ", "W", " ", " ", " ", " ", " ", " ", "W", " ", " ", " ", " ", " ", " ", "W", " ", " ", " ", " ", " ", " ", " ", " ", " ", " ", " ", " ", " ", " ", " ", " ", " ", " ", " ", " ", "W"],
    ["W", " ", "W", "W", "W", "W", "W", " ", "W", "W", "W", "W", "W", "W", "W", "W", "W", " ", "W", "W", "W", "W", "W", "W", "W", " ", "W", " ", "W", "W", "W", "W", "W", "W", "W", " ", "W", " ", "W", " ", "W"],
    ["W", " ", " ", " ", "W", " ", "W", " ", "W", " ", " ", " ", " ", " ", "W", " ", "W", "W", "W", " ", " ", " ", "W", " ", "W", "W", " ", " ", " ", " ", " ", " ", "W", " ", "W", " ", "W", " ", " ", " ", "W"],
    ["W", "W", "W", " ", "W", " ", " ", " ", "W", " ", " ", " ", "W", " ", "W", " ", " ", " ", " ", " ", " ", " ", " ", " ", " ", " ", " ", " ", " ", " ", " ", " ", " ", " ", "W", " ", " ", " ", "W", " ", "W"],
    ["W", " ", "W", " ", "W", " ", "W", " ", " ", " ", "W", "W", "W", " ", "W", "W", "W", "W", "W", "W", "W", " ", "W", "W", "W", " ", "W", " ", "W", "W", "W", " ", "W", " ", "W", " ", "W", " ", "W", " ", "W"],
    ["W", " ", "W", " ", "W", " ", "W", " ", "W", " ", " ", " ", " ", " ", "W", " ", " ", " ", " ", " ", "W", " ", "W", " ", "W", " ", " ", " ", " ", " ", " ", " ", " ", " ", "W", " ", "W", " ", " ", " ", "W"],
    ["W", " ", " ", " ", "W", " ", "W", " ", "W", " ", " ", " ", "W", " ", " ", " ", "W", " ", "W", " ", "W", " ", "W", " ", " ", " ", "W", " ", "W", " ", " ", " ", "W", " ", "W", " ", "W", " ", "W", " ", "W"],
    ["W", "W", "W", " ", "W", "W", "W", " ", "W", "W", "W", "W", "W", " ", "W", "W", "W", " ", "W", "W", "W", "W", "W", "W", "W", "W", "W", "W", "W", " ", "W", "W", "W", " ", "W", "W", "W", "W", "W", " ", "W"],
    ["W", " ", "W", " ", "W", " ", " ", " ", "W", " ", " ", " ", "W", " ", " ", " ", "W", " ", " ", " ", " ", " ", "W", " ", " ", " ", " ", " ", " ", " ", " ", " ", " ", " ", " ", " ", " ", "W", " ", " ", "W"],
    ["W", " ", "W", " ", "W", "W", "W", " ", "W", " ", "W", "W", " ", "W", "W", "W", " ", " ", "W", "W", "W", "W", "W", "W", " ", "W", "W", "W", "W", "W", "W", "W", "W", "W", "W", "W", "W", "W", "W", "W", "W"],
    ["W", " ", " ", " ", " ", " ", " ", "W", " ", " ", " ", "W", " ", " ", " ", " ", " ", " ", " ", " ", " ", " ", " ", " ", " ", " ", "w", " ", " ", " ", " ", " ", " ", " ", " ", " ", "W", " ", " ", " ", "W"],
    ["W", "W", "W", " ", "W", " ", "W", " ", "W", " ", "W", "W", "W", "W", "W", "W", "W", " ", "W", "W", "W", "W", "W", "W", "W", "W", "W", " ", "W", "W", "W", " ", "W", "W", "W", " ", "W", " ", "W", " ", "W"],
    ["W", " ", "W", " ", " ", " ", " ", " ", "W", " ", "W", " ", " ", " ", "W", " ", "W", " ", "W", " ", " ", " ", " ", " ", "W", " ", " ", " ", "W", " ", " ", " ", " ", " ", "W", " ", "W", " ", " ", " ", "W"],
    ["W", " ", "W", " ", "W", " ", "W", " ", " ", " ", " ", " ", "W", " ", "W", " ", "W", " ", "W", " ", "W", " ", "W", " ", " ", " ", "W", " ", "W", " ", " ", " ", "W", " ", "W", " ", "W", " ", "W", " ", "W"],
    ["W", " ", "W", "W", "W", " ", "W", " ", "W", "W", "W", "W", "W", " ", " ", "W", "W", "W", " ", "W", "W", " ", "W", "W", "W", " ", "W", "W", "W", "W", "W", "W", "W", " ", "W", "W", "W", " ", "W", " ", "W"],
    ["W", " ", "W", " ", "W", " ", "W", " ", " ", " ", " ", " ", "W", " ", " ", " ", " ", " ", " ", "W", " ", " ", "W", " ", " ", " ", " ", " ", " ", " ", " ", " ", " ", " ", " ", " ", " ", " ", " ", " ", "W"],
    ["W", "W", "W", "W", "W", "W", "W", "W", "W", "W", "W", "W", "W", "W", "W", "W", "W", "F", "W", "W", "W", "W", "W", "W", "W", "W", "W", "W", "W", "W", "W", "W", "W", "W", "W", "W", "W", "W", "W", "W", "W"]
  ],

  "maze2": [
    ["W", "W", "W", "W", "W", "W", "W", "W", "W", "W"],
    ["S", " ", " ", "W", "W", "W", "W", " ", "W", "W"],
    ["W", "W", " ", "W", "W", " ", " ", " ", " ", "W"],
    ["W", " ", " ", " ", "W", " ", "W", " ", "W", "W"],
    ["W", "W", "W", " ", "W", " ", "W", " ", "W", "W"],
    ["W", " ", "W", " ", " ", " ", "W", " ", "W", "W"],
    ["W", " ", "W", "W", "W", " ", "W", " ", " ", "W"],
    ["W", " ", " ", " ", "W", " ", "W", " ", "W", "W"],
    ["W", "W", "W", " ", " ", " ", " ", " ", " ", "F"],
    ["W", "W", "W", "W", "W", "W", "W", "W", "W", "W"]
  ],

  "maze3": [
    ["W", "W", "W", "W", "W", "W", "W", "W", "W", "W", "W", "W", "W", "W", "W"],
    ["S", " ", " ", " ", " ", " ", "W", " ", "W", "W", "W", "W", " ", " ", "W"],
    ["W", " ", "W", "W", "W", " ", "W", " ", " ", " ", "W", " ", " ", "W", "W"],
    ["W", " ", "W", "W", "W", " ", "W", " ", "W", " ", " ", " ", "W", " ", "W"],
    ["W", " ", "W", " ", " ", " ", "W", " ", "W", "W", "W", "W", "W", " ", "W"],
    ["W", " ", "W", "W", "W", " ", "W", " ", " ", " ", " ", " ", " ", " ", "W"],
    ["W", " ", " ", " ", "W", " ", "W", " ", "W", "W", "W", " ", "W", "W", "W"],
    ["W", " ", "W", " ", "W", " ", " ", " ", " ", "W", " ", " ", " ", " ", "W"],
    ["W", " ", "W", " ", "W", "W", "W", "W", " ", "W", "W", "W", "W", " ", "W"],
    ["W", " ", "W", " ", "W", " ", " ", "W", " ", " ", " ", " ", " ", " ", "W"],
    ["W", " ", "W", " ", " ", " ", " ", "W", "W", "W", "W", "W", "W", "W", "W"],
    ["W", " ", " ", "W", "W", "W", " ", " ", " ", " ", " ", " ", " ", " ", "W"],
    ["W", " ", " ", " ", " ", "W", "W", "W", "W", "W", "W", "W", "W", " ", "W"],
    ["W", " ", "W", "W", " ", " ", " ", " ", " ", " ", " ", " ", " ", " ", "F"],
    ["W", "W", "W", "W", "W", "W", "W", "W", "W", "W", "W", "W", "W", "W", "W"]
  ],

  "maze4": [
    ["W", "W", "W", "W", "W", "W", "W", "W", "W", "W", "W", "W", "W", "W", "W", "W", "W", "W", "W", "W"],
    ["S", " ", " ", " ", " ", " ", "W", " ", " ", " ", "W", "W", "W", "W", " ", " ", " ", " ", " ", "W"],
    ["W", " ", "W", "W", " ", " ", "W", " ", "W", " ", " ", " ", " ", " ", " ", " ", "W", "W", "W", "W"],
    ["W", " ", "W", "W", "W", " ", "W", " ", "W", "W", "W", "W", "W", "W", " ", " ", " ", " ", " ", "W"],
    ["W", " ", "W", " ", " ", " ", " ", " ", " ", " ", " ", " ", " ", "W", "W", "W", "W", "W", "W", "W"],
    ["W", " ", "W", " ", "W", "W", "W", "W", "W", " ", " ", " ", " ", "W", "W", "W", " ", " ", " ", "W"],
    ["W", " ", " ", " ", "W", " ", " ", " ", "W", " ", "W", "W", " ", " ", " ", " ", " ", "W", " ", "W"],
    ["W", " ", "W", "W", "W", " ", "W", " ", " ", " ", " ", "W", " ", "W", "W", "W", " ", "W", " ", "W"],
    ["W", " ", " ", " ", "W", " ", "W", "W", "W", "W", " ", "W", " ", " ", " ", " ", " ", "W", " ", "W"],
    ["W", "W", "W", " ", "W", " ", "W", " ", " ", " ", " ", " ", "W", "W", "W", "W", " ", " ", " ", "W"],
    ["W", " ", " ", " ", "W", " ", " ", " ", "W", "W", "W", "W", " ", " ", "W", " ", " ", "W", " ", "W"],
    ["W", " ", "W", "W", "W", "W", "W", " ", "W", " ", " ", " ", " ", " ", "W", "W", " ", "W", " ", "W"],
    ["W", " ", " ", " ", "W", " ", " ", " ", "W", "W", "W", "W", "W", " ", "W", " ", " ", " ", " ", "W"],
    ["W", " ", "W", "W", "W", "W", "W", "W", "W", " ", " ", " ", " ", " ", "W", " ", "W", "W", " ", "W"],
    ["W", " ", "W", " ", " ", " ", " ", " ", " ", " ", "W", " ", "W", " ", " ", " ", "W", " ", " ", "W"],
    ["W", " ", "W", " ", "W", "W", "W", "W", " ", "W", "W", " ", "W", "W", "W", " ", " ", " ", "W", "W"],
    ["W", " ", "W", " ", "W", " ", " ", " ", " ", "W", " ", " ", "W", " ", " ", " ", "W", " ", " ", "W"],
    ["W", " ", "W", "W", "W", "W", " ", "W", "W", " ", "W", "W", "W", "W", "W", "W", "W", "W", "W", "W"],
    ["W", " ", " ", "W", " ", " ", " ", " ", " ", " ", " ", " ", " ", " ", " ", " ", " ", " ", " ", "F"],
    ["W", "W", "W", "W", "W", "W", "W", "W", "W", "W", "W", "W", "W", "W", "W", "W", "W", "W", "W", "W"]
    ]
}
